







         
EA ./textures/forest-summer.xpm
     NO ./textures/forest-spring.xpm
F 97,52,10
SO                ./textures/forest-autumn.xpm
WE ./textures/forest-winter.xpm
C 189,224,254


        1111111111111111111111111111111111
        1000000000110000000000000000000001
        1011000001110000E00000000000000001
        1001000000000000000000000000000001
111111110011000001110000000000000000000001
100000000011000001110111111111111111000001
11110111111111011100000010001      11110011111
11110111111111011101010010001      10000000001
11000000110101011100010010001      11111111111
10000000000000001100000010001
100000000000000011010100100011111111111111111111111111111111
1100000111010101111101111000011111111110000000001111111111111111111
11110111 1110101 101111010001111111111110000000000111111111111
11111111 1111111 11111111111111111111111110000000001111111111111
1111111111111111111111111111111111111111111111111111111111111111111111111111111



