







         
EA ./textures/forest-summer_blue.xpm
     NO ./textures/forest-spring_blue.xpm
F 97,52,10
SO                ./textures/forest-autumn_blue.xpm
WE ./textures/forest-winter_blue.xpm
C 179,225,251


1111111111111111111111111111111111111111111111111111
1000000000000000000000000000000000000000000000000001
10E0000000000000000000000000000000000000000000000001
1000000000001100111111111110000000000000000000000001
1000000000011000110000000110000000000000000000000001
1000000000110000100000000110000000000000000000000001
1000000001100000000000000110000000000000000000000001
1000000011000000000000011100000000000000000000000001
1000000110000000000001110000000000000000000000000001
1000001100000000000111000000000000000000000000000001
1000011000000000011100000000000000000000000000000001
1000011111111100110000000000001010010101110100100001
1000011111111100110000000010001010001001010110100001
1000000000000100110000000110001010001001010101100001
1000000000000100111111111110001011101001110100100001
1000000000000100000000000000000000000000000000000001
1000000000000000000000000000000000000000000000000001
1111111111111111111111111111111111111111111111111111




