







         
EA ./textures/cartoon_forest4_resized.xpm
     NO ./textures/cartoon_forest4_resized2.xpm
F 0,0,0
SO                ./textures/cartoon_forest5_resized.xpm
WE ./textures/cartoon_forest6_resized.xpm
C 30,30,30


11111111111111111111111111111111
10000000000000000000000000000001
10E00000000000000000000000000001
10000000000011001111111111100001
10000000000110001100000001100001
10000000001100001000000001100001
10000000011000000000000001100001
10000000110000000000000111000001
10000001100000000000011100000001
10000011000000000001110000000001
10000110000000000111000000000001
10000111111111001100000000000001
10000111111111001100000000100001
10000000000001001100000001100001
10000000000001001111111111100001
10000000000001000000000000000001
10000000000000000000000000000001
11111111111111111111111111111111




