







         
EA ./textures/wood_hublot1.xpm
     NO ./textures/wood_hublot2.xpm
F 50,40,30
SO                ./textures/wood_hublot3.xpm
WE ./textures/wood_hublot5.xpm
C 200,190,180


1111111111111111111111111111111111111111111111111111
1000000000000000000000000000000000000000000000000001
10E0000000000000000000000000000000000000000000000001
1000000000001100111111111110000000000000000000000001
1000000000011000110000000110000000000000000000000001
1000000000110000100000000110000000000000000000000001
1000000001100000000000000110000000000000000000000001
1000000011000000000000011100000000000000000000000001
1000000110000000000001110000000000000000000000000001
1000001100000000000111000000001000000000000000000001
1000011000000000011100000000001000000000000000000001
1000011111111100110000000000001010010101110100100001
1000011111111100110000000010001010001001010110100001
1000000000000100110000000110001010001001010101100001
1000000000000100111111111110001011101001110100100001
1000000000000100000000000000000000000000000000000001
1000000000000000000000000000000000000000000000000001
1111111111111111111111111111111111111111111111111111




