







         
EA ./textures/debug64x128.xpm
     NO ./textures/debug128x128.xpm
F 50,255,50
SO               ./textures/debug129x128.xpm
C 189,255,254
WE ./textures/vegetal_wall_4.xpm

111111111111111
100000000000001
101111111111101
1011111111111011111111111
1000000000000000000000001
1111111000111000001110001
      1000111000001110001111111
      1000000000000000000000001
      1111111111101111111111101
                101111111111101
                100000000000001
                1111111S1111111
                1111111111
				1111111
				1111111







