







         
EA ./textures/forest-summer.xpm
     NO ./textures/forest-spring.xpm
F 97,52,10
SO                ./textures/forest-autumn.xpm
WE ./textures/forest-winter.xpm
C 189,224,254


1111111111111111111
1S00011000000000001
1000011000000110001
1000011000000110001
1000000000000110001
1111111111111111111




