







         
EA ./textures/forest-autumn.xpm
     NO ./textures/forest-winter.xpm
F 50,50,50
SO               ./textures/forest-summer.xpm
C 189,255,254
WE ./textures/forest-spring.xpm

111111111111111
100000000000001
101111111111101
1011111111111011111111111
100000E000000000000000001
1111111000111000001110001
      1000111000001110001111111
      1000000000000000000000001
      1111111111101111111111101
                101111111111101
                100000000000001
                111111111111111







