







         
EA ./textures/vegetal_wall_2.xpm
     NO ./textures/vegetal_wall_1.xpm
F 50,50,50
SO                ./textures/vegetal_wall_3.xpm
WE ./textures/vegetal_wall_4.xpm
C 189,224,254





111111111111111
100000000000001
101111111111101
1011111111111011111111111
1000000E00000000000000001
1111111000111000001110001
      1000111000001110001111111
      1000000000000000000000001
      1111111111101111111111101
                101111111111101
                100000000000001
                111111111111111



