







         
EA ./textures/forest-summer.xpm
     NO ./textures/forest-spring.xpm
F 97,52,10
SO                ./textures/forest-autumn.xpm
WE ./textures/forest-winter.xpm
C 189,224,254


        1111111111111111111111111111111111
        1000000000110000000000000000000001
        1011000001110000000000000000000001
        1001000000000000000000000000000001
111111110011000001110000000000000000000001
100000000011000001110111111111111111000001
11110111111111011100000010001      10000011111
11110111111111011100010010001      10000000001
11000000110000011100010010001      11110011111
10000000000000001100000010001        110011
100E00000000000000010100100011111111111001111111111111111111
1100000111000001111101111000011111111110000000001111111111111111111
11110111 1100001 10111101000001111  111110000000000111111111111
11110111 1111111 1111111111100111111111111111110001111111111111
11110111                    10001           1100011
11110111                     10001        11000011
11110111                      100011    1100001111
111101111111111111111111111111110001111100001111111
11110000000000000000000000000000000000000011111
11111111111111111111111111111111111111111111




