







         
EA ./textures/forest-summer.xpm
     NO ./textures/forest-spring.xpm
F 97,52,10
SO                ./textures/forest-autumn.xpm
WE ./textures/forest-winter.xpm
C 189,224,254


        1111111111111111111111111111111111
        1000000000110000000000000000000001
        1001000000110000101110101110100001
        1001000000000001110101110101110001
111111110011000001110000000000000000000001
10000000001100000111011111111111111100000111111
11110111111111011100000010001      100000000001
11110111111111011100100010001      100000000001
11000000110000011100110010001      111100111001
10000000000000001100100010001        1100111001
100E00000000000000000000110011111111111001110011111111111111
1100000111000001111101111000011111111110000000001111111111111111111
11110111 1100001 10111011000001111  111000000000001111111111111
11110111 1111111 1111111100100111111111111111100001111111111111
11110111               1001 1001            1000011
11110111              1001   1001         11000011
11110111             1001     1001      1100001111
111101111111111111111001111111110011111100001111111
11110000000000000000000000000000000000000011111
11111111111111111111111111111111111111111111




