







         
EA ./textures/forest-summer.xpm
     NO ./textures/forest-spring.xpm
F 97,52,10
SO                ./textures/forest-autumn.xpm
WE ./textures/forest-winter.xpm
C 189,224,254


        1111111111111111111111111111111111
        1000000000110000000000000000000001
        1001000000110000101110101110100001
       10001000000000001110101110101110001
   111110011000001110000000000000000000001
   10000001100000111000011111111111100000111111
11110111111111011100000010001      100000000001
11110111111111011100100010001      100000000001
11000000110000011100110010001      111100111001
10000000000000001100100010001         100111001
100E00000000000000000000111111111     1001110011111111111111
1100000111000001111101111   10001     10000000011111111111111111111
11110111 1100011 1011101   1000001    100000000011111111111111
11110111 1111111 111111    1001001    111111000011111111111111
11110111                  1001 1001       1000011
11110111                 1001   1001    11000011
11110111                1001     1001 11100001111
111101111111111111111111001111111110011100001111111
1111000000000000000000000010000000100000000011111
111111111111111111111111111111111111111111111




