







         
EA ./textures/forest-summer.xpm
     NO ./textures/forest-spring.xpm
F 97,52,10
SO                ./textures/forest-autumn.xpm
WE ./textures/forest-winter.xpm
C 189,224,254


1111111111111111111111111111111111111111111111111
1S00000000000000000000000000000000000000000000001
1000000000000000000000000000000000000000000000001
1000000000000000001100000000000000000000010000001
1000000000000000000000000000000000000000000000001
1000000000000000000000000000000000000000000000001
1000000000000000000000000000000000000000000000001
1000000000000000000000000000000000000000000000001
1000000000000000000000000000000000011100000000001
1000000000100000000000010000000000000000000000001
1000000000000000000000010000000000000000000000001
1000000000000000000000010000000000000000000000001
1000000000000000000000000000000000000000000000001
1000000000000000000000000000000000000000000000001
1000000010000000000000000000000000000000000000001
1000000000000000000000000000000000000000000000001
1000010000000000000000000000000000011111100000001
1000010000000000000000000000000000000000000000001
1000010000000000001100000000000000000000000000001
1000010000000000000000000000000000000000000000001
1000010000000000000000000000000000000000000000001
1000010000000000000000000000000000000000000000001
1000010000000000000000000000000000000000000000001
1000000000000000000000000000000000000000000000001
1000000000000000000000000000000000110000000000001
1000000000000000000000000000000000110000000000001
1000000000000000000000000000000000110000000000001
1000000001110000000000000000000000110000000000001
1000000000000000000000000000000000110000000000001
1000000000000000000000000000000000110000000000001
1000000000000000000000000000000110110000000000001
1000000000000000000000000000000000000000000000001
1000000000000000000000000000000000000000000000001
1000000000000000000000000000000000000000000000001
1000000000000000000000000000000000000000000000001
1000000000000000000000000000000000000000000000001
1000000000000000000000000001000000000000000000001
1000000000000000000000000000000000000000000000001
1000000000011111111000000000000000000000000000001
1000000000000000000000000000000000000000000000001
1000000000000000000000000000000000000000000000001
1000000000000000000000000000000000000000000000001
1000010000000000000000000000000000000000000000001
1000000000000000000000000000000000000000000000001
1000000000000000000000000000000000000000000110001
1000011000000000001000000000000000000000000000001
1000000000000000000000000000000000000000000000001
1000000000000000000000000000001110000000000000001
1111111111111111111111111111111111111111111111111




